000000000000000000000000000000000000000000000000000000000000005500000055000000550000005500005500000055000000550000005500000000000000000000000000000000000000000000000000000000000000000000550000005500000055000000000000550000005500000055000000000000000000000000000000000000000000000000000000000000000000005500000055000000550000005500005500000055000000550000005500000000000000000000000000000000000000000000000000000000000000000000550000005500000055000000000000550000005500000055000000000000000000000000000000000000000000000000000000000000000000005500000055000000550000005500005500000055000000550000005500000000000000000000000000000000000000000000000000000000000000000000550000005500000055000000000000550000005500000055000000000000000000000000000000000000000000000000000000000000000000005500000055000000550000005500005500000055000000550000005500000000000000000000000000000000000000000000000000000000000000
000000000000000000000000000000000000000000000000000000000000000000000000000000000000000000000000000000000000000000000000000055555000000000000555550000000055000000000000000000550000000050000000000000000000050000000050000000000000000000050000000050000000000000000000050000000000000000000000000000000000000000000000000000000000000000000000000000000000000000000000000000000000005500000000000000000000000000005500000000000000000000000000555555000000000000000000000000555555000000000000000000000000005500000000000000000000000000005500000000000000000000000000000000000000000000000000000000000000000000000000000000000000000000000000000000000050000000000000000000050000000050000000000000000000050000000050000000000000000000050000000055000000000000000000550000000055555000000000000555550000000000000000000000000000000000000000000000000000000000000000000000000000000000000000000000000000000000000000000000000000
000000000000000000000005555555000000000000000000000005555555000000000000000000000000555555000000000000000000000000555555000000000000000000000000055555000000000000000000000000005555000000000000000000000000000055000000000050000000000000000000000000000555050000000000000000000000005555550000000000000000000000055555550000000000000000000000555555555000000000000000000000055555550000000000000000000000055555550000000000000000000000055555550000000000000000000000055555550000000000000000000000055555550000000000000000000000000000000000000000000000000000000000000000000000000000000000000000000000000000000000000000000000000000000000000000000000000000000000000000000000000000000000000000000000000000000000000000000000000000000000000000000000000000000000000000000000000000000000000000000000000000000000000000000000000000000000000000000000000000000000000000000000000000000000000000000000000000000000000000000000
555555555555555555555555555555555005550055500555005550055500550000500005000050000500005000500000000000000000000000000000000000000000000000000000000000000000000000000000000000000000000000000000000000000000000000000000000000000000000000000000000000000000000000000000000000000000000000000000000000000000000000000000000000000000000000000000000000000000000000000000000000000000000000000000000000000000000000000000000000000000000000000000000000000000000000000000000000000000000000000000000000000000000000000000000000000000000000000000000000000000000000000000000000000000000000000000000000000000000000000000000000000000000000000000000000000000000000000000000000000000000000000000000000000000000000000000000000000000000000000000000000000000000000000000000000000000000000000000000000000000000000000000000000000000000005000500005000050000500005000055005550055500555005550055500555555555555555555555555555555555
000000055500000000555000000000000000055500000000555000000000000000055500000000555000000000000000055500000000555000000000000000055500000000555000000000000000055500000000555000000000000000055500000000555000000000000000055500000005555500000000000000055500000005555500000000000000055500000005555500000000000000055500000000000000000000000000555550000000000000000000000000555550000000000000000000000000555550000000000000000000000000000000000000000000000000000000000000000000000000000000000000000000000005555500000000000000000000000005555500000000000000000000000005555500000000000000000000000000555000000000000000000000000000555000000000000000555550000000555000000000000000555550000000555000000000000000555550000000555000000000000000055500000000555000000000000000055500000000555000000000000000055500000000555000000000000000055500000000555000000000000000055500000000555000000000000000055500000000555000000000
000000000000000000000000000000000000000000000000000000000000000000000000000000000000000000000000000000000000000000000000000000000000000000000000000000000000000000000000000000000000000000000000000000000000000000000000000000555555000000000000000000000000500005000000000000000000000000000000000000000000000000000000000000000000000000000000000000000000000000000000000000055000000000000550000000000000050000000000000050000000000000050000005500000050000000000000050000005500000050000000000000050000000000000050000000000000055000000000000550000000000000000000000000000000000000000000000000000000000000000000000000000000000000000000000000000000000000500005000000000000000000000000555555000000000000000000000000000000000000000000000000000000000000000000000000000000000000000000000000000000000000000000000000000000000000000000000000000000000000000000000000000000000000000000000000000000000000000000000000000000
000000000000000000000000000000000000000000000000000000000000000000000000000000000000000000000000000000000000000000000000000000050000000000000050000000000000550000000000000055000000000000000000000000000000000000000000000000000000000000000000000000000000000000000000000000000000000055500055500000000000000000000050000000500000000000000000000050000000500000000000555000000050000000500000000555555000000050000000500000000555000000000050000000500000000000000000000050000000500000000000000000000055555555500000000000000000000000000000000000000000000000000000000000000000000000000000000000000000000000000000000000000050000000500000000000000000000050000000500000000000000000000055555555500000000000000000000000000000000000000000000000000000000000000000000000000000000000000000000000000000000000000000000000000000000000000000000000000000000000000000000000000000000000000000000000000000000000000000000000000000
000000000000000000000000000000000000000000000000000000000000000000000000000000000000000000000000000000000000000000000000000000000000000000000000000000000000000000000000000000000000000000000000000000000000000000000000000000000000000000000000000000000000000000000000000000000000000000000000000000000000000000005500000005500000000000000000005500000005500000000000000000555555000555555000000000000000555555000555555000000000000000005500000005500000000000000000005500000005500000000000000000000000000000000000000000000000000000000000000000000000000000000000000000000000000000000000000000000000000000000000000000000000000000000000000000000000000000000000000000000000000550000000000000550000000000000550000000000000550000000000000555555555555555000000000000000555555555555555000000000000000000000000000000000000000000000000000000000000000000000000000000000000000000000000000000000000000000000000000000000000
000000000000000000000000000000000000000000000000000000000000000000000000000000000000000000000000000000000000000000000000000000000000000000000000000000000000000000000000000000000000000000000000000000000000000000000000000000000000000000000000000000000000000000000000000000000000000000000000000000000000000005550000000055550000000000000055555000000555555000000000000555555500000055550000000000000055555000000000000000000000000000000000000000000000000000000000000000000000000000000000000000000000000000000000000000000000000000000000000000000000000000000000000000000000000000000000000000000000555500000005000000000000055500000000000055055550000000000000000000000005000000000000000000000000000005000000000000000000000000000005000000000000000000555555550005000000000000555555555555550005555555550000555555555555550005555555550000555555555555550055555555550000555555555555550055555555550000555555555555550055